dirty things (sex)	trucs salaces
thus	a ainsi
open air	a ciel ouvert
with regard to	a l&#x27;égard de
in my defense	a ma décharge
to the extent that	a tel point que
as you wish	a votre guise
to lower	abaisser
to slaughter	abattre
to damage	abîmer
to abolish	abolir
to address (a subject)	aborder
to result in	aboutir à
to abreviate	abréger
to shelter	abriter
fool	abruti
to exaggerate	abuser
to hog	accaparer
to accentuate	accentuer
incidentally	accessoirement
to access	accéder
to accomplish	accomplir
to grant	accorder
to hang/hook	accrocher
to increase	accroître
welcoming	accueillant
to welcome	accueillir
to route/forward	acheminer
to finish	achever
to acquire	acquérir
to pay off	acquitter
shareholder	actionnaire
suitable	adapté
adequate	adéquat
member	adhérent
membership	adhésion
to admit	admettre
to soften	adoucir
to befall	advenir
to weaken	affaiblir
to starve	affamer
to display	afficher
to flock	affluer
frightful	affreux
to face	affronter
in order to / so that	afin de / afin que
so that I can	afin que je puisse
to annoy	agacer
Annoyed	Agacé
annoying	agaçant
to worsen	aggraver
to enlarge	agrandir
to attack	agresser
agricultural	agricole
bravo	Ah bah bien
sour	aigre
embittered	aigri
bitter	aigris
elsewhere	ailleurs
kind	aimable
and so on	ainsi de suite
Thus	ainsi donc
as well as	ainsi que
easy	aisé
to adjourn	ajourner
brother	Akhi
alcoholic	alcoolisé
surroundings	alentours
random	aléatoire
to alleviate	alléger
to combine	allier
ally	allié
to lengthen	allonger
to allocate	allouer
to turn on	allumer
while	alors que
to weigh down	alourdir
to coax/butter up	amadouer
ambitious	ambitieux
bitter	amer
to arrange (furniture-wise)	aménager
friendly	amical
friendship	amitié
to initiate	amorcer
to anchor	ancrer
to wreck	anéantir
harmless	anodin
painkillers	antalgiques
to soothe	apaiser
to perceive	apercevoir
apparently	apparemment
to belong	appartenir
to bait	appâter
learners	apprenants
apprentice	apprenti
to apprehend/grasp	appréhender
to prepare	apprêter
to deepen	approfondir
appropriate	approprié
to press/support	appuyer
after stopping	après avoir fait escale
able to	apte à
very	archi
silverware	argenterie
cupboard/wardrobe	armoire
to tear	arracher
sick leave	arrêts maladie
aftertaste	arrière goût
to round	arrondir
district	arrondissement
to water	arroser
to sprinkle	asperger
vacuum cleaner	aspirateur/aspi
to vacuum	aspirer
to aspire to	aspirer à
to season	assaisonner
long enough	assez longtemps
to assimilate	assimiler
to attend a concert	assister à concert
to match	assortir
to appease	assouvir
to take responsibility/to rock it	assumer
to ensure	assurer
certainly	assurément
atrocious	atroce
to reach	atteindre
to land	atterrer
to land	atterrir
to lessen	atténuer
attractiveness	attirance
to catch	attraper
attractive	attrayant
on the edge of	au bord de
At the seaside	au bord de la mer
back to work!	au boulot!
at the end of	au bout de
at the end of the line	au bout du fil
chillin/the audacity!	au calme
in case you forgot	au cas tu l&#x27;avais oublié
during	au cours de
over the years	au cours des ans
Beyond	au delà de
above	au dessus
gradually	au fur et à mesure
according to	au fur et à mesure de
gradually as	au fur et à mesure que
as well as	au même titre que
in the middle	au milieu
in terms of	au niveau de
on a side note	au passage
off the top of your head	au pif
ASAP	au plus rapide/au plus crisse (canada)
In regards to	au regard de
Help!	au secours
figuratively	au sens figuré
beyond	au-delà
beyond this date	au-delà de cette date
above	au-dessus
no doubt about it	aucun doute là-dessus
in no way	aucunement
near	auprès de
with you	auprès de vous
in which case	auquel cas
as interesting as	aussi intéressant que
that fast	aussi vite
immediately	aussitôt
as much	autant de
as much as	autant que
sticker	autocollant
independent	autonome
in the old days	autrefois
otherwise	autrement
others	autrui
swallow/to get down food	avaler
to venture	aventurer
to warn	avertir
blind	aveugle
to have in mind	avoir bien en tête
to look healthy	avoir bonne mine
to have abs	avoir des abdos/avoir un six pack (canada)
to have fun	avoir du fun (canada)
to be lucky	avoir du pot
to be used to	avoir l&#x27;habitude
to feel like	avoir l&#x27;impression de
to have luck	avoir la baraka
I have a bad cold	avoir la crève
to be very hungry	avoir la dalle
to be hungover	avoir la gueule de bois
to be knowledgeable of plants	avoir la main verte
to be pissed off	avoir le seume
to have a headache	avoir mal au crâne ?
to be unable to speak	avoir un chat dans la gorge
to fall in love easily	avoir un coeur d&#x27;artichaut
to be slightly hungry	avoir un petit creux
to focus	axer
breathtaking	à couper le souffle
to go (ordering)	à emporter
with regard to	à l&#x27;égard de
nothing fancy / sans chi chi	à la bonne franquette
mass produced	à la chaîne
instead of	à la place de
looking for a job	à la recherche d&#x27;un emploi
in the evening	à la veillée
"to it&#x27;s own right	à part entier
from	à partir de
from now on	à partir de cet instant
from now on	à partir de maintenant
as far as the eye can see	à perte de vue
without his knowing	à son insu
see you later	À tantôt (canada)
loosely (figuratively)	à tort et à travers
at all costs	à tout prix
around	àux alentours de
to tarnish	bafouer
to fight	bagarrer
school, taxi, truck	bahut
to bathe	baigner
to yawn	bailler
to lower	baisser
to sweep	balayer
ball/bullet	balle
euros	balles
to have a hard on	Bander
to banish	bannir
barbaric	barbare
to bar	barrer
to toggle	basculer
sneakers	baskets
talkative	bavard
to talk	bavarder
to drool	baver
to build	bâtir
beak	bec
to eat	becqueter
to eat	becqueter/grailler
donut	beignet
attention	Belek
weed	beuh
to stutter	bégayer
to benefit	bénéficier
volunteer	bénévole
to bless	bénir
stupid	bête(teubê)
much worse	bien moins bon
wuz good my G	bien ou quoi chacal
although	bien que
well being	bien-être
public property	biens publics
to dick slap	bifler
jewelry, gem	bijoux
jaded	blasé
armored	blindé
blah	bof
Voice mail	boite vocal
case	boîtier
enjoy watching it	bon visionnage
good places	bonnes adresses
messy	bordélique
to limit	borner
hard worker	bosseur acharné
bite	bouchée
to buckle/loop	boucler
to garble	bouffer
swollen	bouffi
candle	bougie
to upset	bouleverser
lint	bouloche
to eat without thinking too much	boulotter
to stuff	bourrer
full of parasites	bourré de parasites
to shove/rush	bousculer
piece	bout
shops	boutiques
to plug in	brancher
to brandish	brandir
to rob	braquer
sheep	brebis
to tinker	bricoler
briefly	brièvement
bun	brioche
to break	briser
to scramble	brouiller
to cover your tracks	brouiller les pistes
abruptly	brusquement
raw	brut
noisy	bruyant
burning	brûlure
to stumble, kill	buter
from then on that	c&#x27;est ainsi que
"it&#x27;s that bad, it&#x27;s to that point	"c&#x27;est à ce point
"it&#x27;s a close one/sketchy	"c&#x27;est chaud
"c&#x27;est bien	"c&#x27;est correc (canada)
"it&#x27;s stupid	"c&#x27;est débile
"it&#x27;s fire/fuego	"c&#x27;est du lourd
"it&#x27;s great	"c&#x27;est écœurant (canada)
it's greasy	c&#x27;est gras/c&#x27;est cochon (canada)
"it&#x27;s a good deal	"c&#x27;est intéressant
"it&#x27;s the end of the world	"c&#x27;est la fin des haricots
"it&#x27;s the least of things	"c&#x27;est la moindre des choses
"it&#x27;s kind of...	"c&#x27;est limite...
"it&#x27;s my thing	"c&#x27;est ma came
"it&#x27;s not the best	"c&#x27;est pas top
"it&#x27;s the exact year	"c&#x27;est pile l&#x27;année
what the heck	c&#x27;est quoi ce bordel
"it&#x27;s tight	"c&#x27;est serré
"it&#x27;s a mess	"c&#x27;est un bordel
he's rotten	c&#x27;est un pourri
she a hottie	c&#x27;est une bombe/frappe
"it&#x27;s bullshit	"c&#x27;est une connerie
it was fire/lit	c&#x27;était le feu
"I don&#x27;t mind eating it	ca me gêne pas de le mange
padlock	cadenas
to give someone attention	calculer
pun	calembour
to burgle	cambrioler
to camouflage	camoufler
prank	un canular
to be impatient, excited, angry, annoyed, crazy	capoter (canada)
condoms	capotes
to capture	capter
pen cap	le capuchon
tile	carreau
to trick/swindle	carroter
yellow card	carton jaune
ink cartridge	cartouche d&#x27;encre
get lost	casse-toi
to break	casser
wine shop	caviste
to cuddle	câliner
this gear	ce matos
this dump	ce taudis
it may seem crazy to you	cela peut vous sembler fou
supposed	censé
cents	centimes
to center	centrer
to identify	cerner
to ascertain	cerner
Some of you	certains d&#x27;entre vous
certainly, of course (super formal)	certes
to give up your seat	céder sa place
homeboy, you gossiped alot	chacal t&#x27;as bien kouma
warm	chaleureux
blowtorch	chalumeau
candle	chandelle
"to change one&#x27;s mind	"changer d&#x27;avis
sick!	chanmé
to sing without knowing the lyrics	chanter en yaourt
giberish	charabias
to hunt	chasser
to heat	chauffer
lime	chaux
mouth	che-bou/bouche
ugly	cheum (moche)
reverse cowgirl	cheval inversé
to ride	chevaucher
at my place	chez ouam (chez moi)
goats	chèvres
I do not know	ché ap (je sais pas)
to shit	chier
revenue	chiffre d&#x27;affaire
to put a number on	chiffrer
sissy	chochotte
to catch (slang)	choper
pamper	chouchouter
regarde	chouf
a little	Chouiya
Christian	chrétien
to whisper	chuchoter
to plummet	chuter
to target	cibler
cemetery	cimetière
cinema	cinéma=ciné
citizen	citoyen
to slam/snap (fingers)	claquer
slides	claquettes
to classify	classer
binder	classeur
to lock	cleffer
dog	clébard
to blink	cligner
cigarette	clope, sèche
to close off	clore
teammates	coéquipiers
to jam	coincer
stuck	coincé
parcel	colis
turtlenecks	cols roulés
wet suit	combinaison de plongée
to fill in	combler
fill the void	combler le vide
comical	comique
like that	comme as (comme ça)
Like all of you	Comme vous tous
trader	commerçant
to commit	commettre
to appear	comparaître
to dial a number	composer un numéro
including	compris
to compromise	compromettre
to plan	compter
to consult	concerter
to create	concevoir
to conclude	conclure
cucumber	concombre
in concrete terms	concrètement
to carry out	concrétiser
competitive	concurrentiel
to condemn	condamner
condemn	condamner
to confide a secret	confier un secret
to confine	confiner
to confuse	confondre
in accordance with	conformément à
day off	congé
bullshit	connerie
to conquer	conquérir
devote	consacrer
to devote to	consacrer à
to consent	consentir
instructions	consignes
to consist of	consister à
constantly	constamment
to note	constater
to satisfy	contenter
contents	contenu
to bypass	contourner
to compel, constrain	contraindre
contrary to	contrairement à
to annoy	contrarier
to upset	contrarier
against all expectations	contre toute attente
rewards	contreparties
to counter	contrer
offender	contrevenant
controversial	controversé
convincing	convaincant
to convince	convaincre
suitable	convenable
to agree	convenir de
friendliness	convivialité
to coordinate	coordonner
wastepaper basket	corbeille
to correspond	correspondre
to corrupt	corrompre
to quote/rate	coter
sunset	coucher de soleil
to sew	coudre
to sink/flow	couler
love at first sight	coup de foudre
current	courant
alternating current	courant alternatif
crown	couronne
to crown	couronner
to cost a shit ton	couter la peau du cul
expensive	coûteux
to spit/to talk badly about someone	cracher
to fear	craindre
fearful	craintif
to screw up	cramer
to march	crapahuter
to smoke without inhaling	crapoter
to crack	craquer
to dig	creuser
to build momentum	créer un élan
riddled with holes	criblée de trous
to cross	croiser
to run into people	croiser des gens
arm cross, iron cross, if I lie, I go to hell	croix de bras, croix de fer, si je mens, je vais en enfer
to grow	croître
to grow as a person	croître comme personne
to munch	croquer
to crunch	croquer
crispy	croustillant
corny	cucul
leather	cuir
to cook/bake	cuire
cynical	cynique
"that&#x27;s hot (slang)	"ç&#x27;est chaud ça
"it&#x27;s cold af	ça caill
"There&#x27;s nothing complicated to it	ça casse trois pattes à un canar
that works (slang)	ça colle
it attracts	ça draine
"how&#x27;s it going?	ça gaze
it didnt work for me	ça m&#x27;a pas réussi
that seemed to me	ça m&#x27;a semblé
it slipped my mind	ça m&#x27;est sorti de la tête
that gets me fired up	ça me crinque
it makes me feel good	ça me fait du bien
that triggers me	ça me trigger
it suits me	ça me va
never mind	ça ne fait rien
"it&#x27;s up to you	"ça ne tient qu&#x27;a vous
"it doesn&#x27;t look good but it&#x27;s good	ça paye pas de min
it works for me	ça roule ma poule
maybe	ça se trouve
it shows that	ça se voit que
gimme a minute	ça sera pas long (canada)
Does it ring a bell?	ça te dit quelque chose?
good timing	ça tombe bien
"it&#x27;s their charm	c’est leur kif
according to	d&#x27;après
at heart	dans l&#x27;âme.
in denial	dans le déni
more connected to the organization	davantage branché sur l&#x27;organisation
basic	de base
initially	de base/à la base
on the other hand	de l&#x27;autre côté
as well as	de même que
From nowhere	de nulle part
totally!	de ouf
such	de tels
sometimes	de temps en temps
in person	de vive voix
inside Outside	dedans dehors
to live	demeurer
to remain	demeurer
young lady	demoiselle
for a while	depuis un moment
recently	dernièrement
lmfao	des barres
suspenders	des bretelles
trouble	des ennuis, le pétrin
quotation marks	des guillemets
wrinkles	des rides
Huge sums	des sommes faramineuse
to serve	desservir
to draw	dessiner
destiny	destin
debts	dettes
one sec!/real quick!	deuspi/2spi (speed)
to have to go	devoir se rendre
as soon as I can	dès que je peux
to disembark	débarquer
to rid	débarrasser
to debate	débattre
to clear	déblayer
to overflow	déborder
to end up with	déboucher sur
to untangle	débrouiller
postpone	décaler
to detect	déceler
to award	décerner
disappointing	décevant
death	décès
to decease	décéder
to unload	décharger
waste	déchet
to shred	déchiqueter
to tear	déchirer
to rant	déclamer
declare his love to someone	déclarer sa flamme a quelqu&#x27;un
to trigger	déclencher
to take off	décoller
to unwind	décompresser
to relax	décontracter
to result from	découler de
to cut/carve	découper
to discourage	décourager
discovery	découverte
to decree	décréter
to put down (emotionally)	décrier
to unhook	décrocher
to pick up the phone	décrocher
to dedicate	dédier
compensation	dédommagement
deduct/deduce	déduire
to defend	défendre
to challenge	défier
to march/parade/scroll	défiler
to let off steam	défouler
to be cleared	défricher
to emit	dégager
to clear up	dégager
damage	dégât
to disgust	dégoûter
to disguise	déguiser
to enjoy (food-wise)	déguster
itching	démangeaisons
to dismantle	démanteler
to activate	démarrer
to deny	démentir, nier
to move to	déménager à
to resign	démissioner
to resign	démissionner
to smoke out	dénicher
to troubleshoot	dépanner
to surpass	dépasser
to exceed the limits	dépasser les limites
to skin	dépecer, écorcher
to spend	dépenser
to wither away	dépérir
to dispatch	dépêcher
uncalled for	déplace
to displease	déplaire
to drop off	déposer
to strip	dépouiller
to derail	dérailler
disturbing	dérangeant
to bother	déranger, turlupiner, embêter, gêner
to drift away	dériver
to steal	dérober
to unroll	dérouler
defuse	désamorcer
to grieve	désoler
henceforth, from now on	désormais/dorénavant
to give detail	détailler
to loosen	détendre
relaxed	détendu
relaxation	détente
determined	déterminé/déter
to divert	détourner
to destroy	détruire
to reveal	dévoiler
to devour your food	dévorer
to devote	dévouer
spread/broadcast	diffuser
to digest	digérer
to decrease	diminuer
to manage a team	diriger une équipe
to disappear	disparaître
to arrange	disposer
to conceal	dissimuler
to dissipate	dissiper
to dissolve	dissoudre
to divide	diviser
a liar (african french?)	Djadja
Finger me	Doigte-moi
to tame	dompter
to give up	donner sa langue au chat
whose	dont
golden	doré
from now on	dorénavant
to endow	doter
customs	douanes
double ply	double épaisseur
to dub	doubler
gently	doucement
sweets	douceurs
puffy jacket	doudoune
gifted	doué
soft,sweet	doux
a dispute	drah
to draw up	dresser
so, therefore, as a result	du coup
some dope	du shit
asshole	ducon
to energize	dynamiser
to erase	effacer / gommer
to carry out	effectuer
performed	effectué
to brush against	effleurer
to frighten	effrayer
she ended up learning english	ella a fini par apprendre l&#x27;anglais
She really fell in love with the dress	Elle a vraiment eu un coup de coeur pour la robe
She bad	Elle est bad
she fugly	elle est cheum/éclaté
"she&#x27;s taken	elle est maqué
to wrap (packaging) / to french kiss	emballer
to hire	embaucher
iconic	emblématique
to press	embobiner
to confuse	embrouiller
to hassle	emmerder
to move in	emménager
to stuff	empailler
prevent	empêcher
to get worse	empirer
to imprison	emprisonner
to borrow	emprunter
backward	en arrière
below	en bas
doggy style	en catchana/la levrette/à 4 pattes
in summer camp	en colonie
into account	en compte
in return	en contrepartie
underneath, below	en dessous
messy	en désordre
in entirety	en entier
at the end of the day	en fin de journée
depending on	en fonction de
in terms of	en fonction de
on top	en haut
in terms of	en matière de
on average	en moyenne
by the way	en passant
in the heart of nature	en plein dans la nature
in addition to	en plus de
in shoe size	en pointure
in a manner of speaking	en quelque sorte
in relation to	en rapport à
holding back our breath	en retenant notre souffle
On the other hand	En revanche
In general	en règle général
knowing that	en sachant que
in itself	en soi
in any case	en soit
so that	en sorte que
as	en tant que
as such	en tant que tel
in any case	en tout cas
to cash out	encaisser
pregnant	enceinte
to chain	enchaîner
against	encontre
to damage	endommager
to put asleep	endormir
to scam	enfler, escroquer
to press in	enfoncer
to infringe	enfreindre
to hire	engager
to procreate	engendrer
to encompass	englober
to remove	enlever
to take off	enlever
to investigate	enquêter sur
to enrich	enrichir
to wrap (round stuff)	enrouler
to begin	entamer
hear through gossip/rumors	entendre dire
to bury	enterrer
enthusiastic	enthousiaste
to tangle	entortiller
to surround	entourer
to hinder	entraver
in the meantime	entre-temps
to undertake	entreprendre
to maintain	entretenir
job interview	entretien d&#x27;embauche
to glimpse	entrevoir
to invade	envahir
to envelop	envelopper
towards	envers
About two	environ deux
to consider the future	envisager l&#x27;avenir
exhausted	epuisé
to wonder	errer
wrong	erroné
to expect	escompter
scammers	escrocs
to wipe	essuyer
next step	etape suivante
to be dead	etre décédé
to be mourning	etre en deuil
to be smart	etre futé
to be handcuffed	etre menotté
to be as flat as a pancake	etre plate comme un limande
to be crazy	etrê taré
to exclude	exclure
to urge	exhorter
to dispatch	expédier
to atone	expier
to exploit	exploiter
to explode	exploser
on purpose	exprès
exquisite	exquise
to extract	extraire
extroverted	extraverti
to rattle	ébranler
to discard	écarter
to exchange	échanger
to escape	échapper
to clarify	éclaircir
to light up	éclaire
to illuminate	éclairer
to burst	éclater
to burst out laughing	éclater de rire
to burst into tears	éclater en sanglots
sickened	écoeuré
eco-friendly	écolo
bark	écorce
selling out	écouler
to crush/overwrite	écraser
to build	édifier
equality	égalité
scratch	égratignure
to elaborate/create	élaborer
to widen	élargir
to elect	élire
speech	élocution
to ward off	éloigner
to emanate	émaner
renowned	éminent
emotional	émotif
move (emotionally)	émouvoir
enunciate/state	énoncer
thick	épais
blossoming	épanoui
to save money	épargner de l&#x27;argent
to spell	épeler
mop up	éponger
appalling	épouvantable
to experience	éprouver de
to exhaust	épuiser
horse riding	équitation
to equivalate to	équivaloir a
to erect (building-wise)	ériger
to establish	établir
shelves	étagères
to spread	étaler
to turn off	éteindre
to spread	étendre
to stretch	étirer
shooting Stars	étoiles filantes
astonishing	étonnant
to choke/smother	étouffer
narrow	étroit
to stimulate	éveiller
to fan	éventer
eventually	éventuellement
event	événement
to evolve	évoluer
to recall	évoquer
to be addicted	être accro
to be seated	être attablé
to be on the verge of doing something	être à deux doigts de faire quelque chose
to be all in/to go hard	être à fond
to be safe	être à l&#x27;abri
to be spacing out	être à l&#x27;ouest
to be boring	être barbant
to be fake	être bidon
to be in love with someone	être bleu de quelqu&#x27;un
to be nuts	être cinglé
to be in cahoots	être de mèche
to be resourceful	être débrouillard
to be hammered	être déchiré
to be angry	être en colère
to be booming	être en plein essor
to be kidnapped	être enlevé
to be amazed	être épaté
to be sensitive to the cold	être frileux/frileuse
to be pissed	être furax
to be rude	être grossier
to be uncompromising	être intransigeant
to be lost	être paumé
to be tipsy	être pompette
to be back in the saddle	être remonté  en selle
to be legitimate	être réglo
to be on thin ice	être sur la corde raide
to be all ears	être tout ouïe
to be a couch potato	être un légume
to be targeted	être visé
in front of	face à
to ease	faciliter
to charge	facturer
optional	facultatif
low cost	faible coût
to fail to	faillir à
lazy	fainéants
to squirt	fair gicler
to smudge	faire baver
to piss off	faire chier
to guilt trip	faire culpabiliser
to do some maintenance work	faire de travaux
to do situps	faire des abdominaux/abdos
to have sex (sexually)	Faire des galipettes
to tickle/fool around	Faire des gouzis, faire des papouilles
to have dreams	faire des rêves
to take a nap/sleep	faire dodo
to blackmail	faire du chantage
to hitchhike	faire du stop
to be careful	faire gaffe
to woo someone	faire la cour à quelqu&#x27;un
to party	faire la fête
to sleep in	faire la grasse matinée
to sulk, to be upset	faire la gueule
to focus (camera)	faire le point
to go shopping	faire les magasins
to dangle	faire miroiter
to do 50/50	faire moit moit
to be part of	faire partie de
to grow fruits	faire pousser des fruits
to lobby	faire pression
to demonstrate	faire preuve
to pretend to	faire semblant de
"to take it&#x27;s toll	faire son oeuvre
to drop	faire tomber
make a wish	faire un voeux
to take a break	faire une pause
Get tested	Fais toi dépister
let me see	fais voir
do me a handjob	Fais-moi une branlette
do not	fallait pas
host family	famille d&#x27;accueil
to stuff	farcir
burden	fardeau
wacky	farfelue
shy/wild	farouche
otherwise	faute de quoi
Wheelchair	fauteuil roulant
favorite	favori
to promote	favoriser
to promote	favoriser de
firmly	fermement
firmly	fermement
Railway	ferroviaire
fertility	fécondité
to congratulate	féliciter
fierce	féroce
to celebrate	fêter
reliable	fiable
to file	ficher
faithful	fidèle
proud	fier
to clot, coagulate	figer
to tweak	fignoler
to represent	figurer
to give (slang)	filer
to spin	filer
to leave (in a polite way)	filer
subsidiaries, branches	filiales
tax	fiscale
torch	flambeau
to stroll	flâner
to stroll without a specific destination	flâner
to float	flotter
hay	foin
dark	foncé
founded by	fondé par
to melt	fondre
necessarily	forcément
necessarily	forcément
to drill	forer
formal	formel
to rummage	fouiller
to poke around	fouiner
he sprained his ankle	il s&#x27;est foulé la cheville
deceit	fourberie
to provide	fournir
to stuff	fourrer
the impound	fourrière
bullshit!	foutaises!
raspberry	framboise
to cross	franchir
to cross the threshold	franchir le seuil
french origin (expression controversée)	français de souche
bro	frangin, frérot
sis	frangine
hit by lightning	frappé par la foudre
to kiss	frencher (canada)
to show off	frimer
to fry	frire
crumple	froisser
wheat	froment
forehead	front
to rub	frotter
to run away	fuir
leak	fuiter
the goalie	gardien de but
to park	garer
to waste	gaspiller
waffle	gaufre
to arrest	gauler
force feeding	gavage
to spoil (food), to waste	gâcher
yea right	genre
to puke	gerber
giant	géant
to generate	générer
drager/to manage	gérer
awkward	gênant
to slap	gifler
gigantic	gigantesque
to wiggle	gigoter
to be doing nothing	glander
to slide/slip	glisser
to eat in one go	gober
rubber/gum	gomme
Inflate/to annoy	Gonfler
greedy	gourmand, avide
tasty	goûteux
to scratch	gratter
to ascend	gravir
frog	grenouille
toaster	grille-pain
to scold	gronder
rude/rough	grossier
to get bigger	grossir
roughly speaking	grosso modo
to swarm	grouiller
grated cheese	gruyère râpé
to look out	guetter
to heal	guérir
to guide	guider
clothes	habits
usually	habituellement
to get used to	habituer
to hate	haïr
to haunt	hanter
to harass	harceler
harassment	harcèlement
to raise	hausser
high	haut
top of the line	haut de gamme
loud speaker	haut parleur
hasty	hâtif/hative
weekly	hebdomadaire
to bump	heurter
to harbor	héberger
to host someone	héberger quelqu&#x27;un
to inherit	hériter
to hoist	hisser
to nod your head	hocher la tête
counterpart	homologue
counterpart	homologue
ladies First	honneur aux dames
shameful	honteux
schedule	horaire/emploi du temps
apart from	hormis
offside	hors-jeu
to howl	hurler
identical	identique
lgbqt neutral pronoun	iel
dog (yiaach)	iench(yiaach)
he has a sick ride	il a une caisse de malade
it's like that	il en est ainsi
he is lacking money	il est en galère d&#x27;argent
it is derived	il est issu
once upon a time	il était une fois
"it&#x27;s chilly	il fait frai
it rains alot	il flotte beaucoup
"he&#x27;s relou	il force lu
he swindled me	il m&#x27;a carotté
I need to leave (its beyond my control)	Il me faut partir
nobody is here	il n&#x27;y a pas un chat
He rarely talks about his job	Il ne parle guère de son travail
"it&#x27;s about that	"il s&#x27;agit de ça
what happened	il s&#x27;est passé quoi
he hooked up with marion	il s&#x27;est tapé marion
he made fun of her	il se foutait de sa gueule
it is possible that	il se peut que
It would be better	il vaut mieux
there is something fishy	il y a anguille sous roche
there are good days and bad days	il y a des jours avec et des jours sans
"There is something for everyone&#x27;s taste	il y en a pour tous les goût
there are a lot of criteria that come into account	il y’a pleins de critère qui rentre en compte
to illustrate	illustrer
they got me	ils m&#x27;ont eu
They say that	Ils paraient que
to immerse	immerger
filth	immondice
tax	impôt
stunning	imprenable
powerless	impuissant
to attribute	imputer
unfinished	inachevé
to incarnate	incarner
to include	inclure
to be undertaken on	incomber à
to charge, accuse	inculper
indigenous	indigène
to induce	induire
unusual	inédite
infinitely	infiniment
to inflict	infliger
influential	influent
to influence	influer
to eat quickly	ingurgiter
unusual	inhabituel
to flood	inonder
to register	inscrire
foolish	insensé
to insert	insérer
tasteless	insipide
to establish	instaurer
to institute	instituer
to instruct	instruire
internal and external	interne et externe
to question	interpeller
to call on	interroger
to interrupt	interrompre
to integrate	intégrer
intimate	intime
to intimidate	intimider
to title	intituler
to invert	inverser
to invest	investir
to isolate	isoler
itinerary	itinéraire
I barely understood	j&#x27;ai compris à peine
i crossed the line	j&#x27;ai dépassé les bornes
I have trouble understanding	j&#x27;ai du mal à comprendre/j&#x27;ai de la misère à comprendre (canada)
I heard that..	j&#x27;ai entendu dire que..
I was caught in the act	j&#x27;ai ete pris en flagrant délit
I was raised in Berlin	j&#x27;ai été élevé à Berlin
I almost..	J&#x27;ai failli + inf
I almost got scammed	J&#x27;ai failli me faire avoir
I almost got caught	J&#x27;ai failli me faire gauler
its so hot/I really liked it	j&#x27;ai grave chaud/je l&#x27;ai grave aimé
I dont feel like it	j&#x27;ai la flemme
I bit off more than I can chew	j&#x27;ai les yeux plus gros que le ventre
I screwed up	j&#x27;ai merdé
I worked a good amount	j&#x27;ai pas mal bossé
I have quite alot of work	j&#x27;ai pas mal de boulot
<div>The front of this card is blank.<br><a href='https://anki.tenderapp.com/kb/card-appearance/the-front-of-this-card-is-blank'>More information</a></div>	<div>The front of this card is blank.<br><a href='https://anki.tenderapp.com/kb/card-appearance/the-front-of-this-card-is-blank'>More information</a></div>
I have a ton of work	j&#x27;ai un max de boulot
"I&#x27;ll be right back	"j&#x27;arrive
I am fed up with everything	j&#x27;en ai marre de tout
"I&#x27;m fed up	"j&#x27;en ai marre/j&#x27;suis tané (canada)
"I&#x27;m fed up	"j&#x27;en ai ras le bol
I hope you liked it	j&#x27;espère que ça vous a plus
I was SO tired	j&#x27;étais au bout de ma vie
I was in flirty mode	j&#x27;étais en mode gros drageur
I was in party mode	j&#x27;étais en mode soirée
"I can&#x27;t beleive it!	"j&#x27;hallucine!
formerly	jadis
"I&#x27;m afraid I disagree	"je crains d&#x27;être en desaccord
"fuck it, I don&#x27;t have the answer)	je donne ma langue au cha
"I&#x27;d better try	"je ferais mieux d&#x27;essayer
"I&#x27;m freaking out	je flippe à mor
I got a bad feeling	je le sens mal
"I&#x27;m off	"je m&#x27;arrache
"I&#x27;ll take care of it	"je m&#x27;en charge
I would gladly do without	je m&#x27;en passerai volontiers
im running the cash register	je m&#x27;occupe de la caisse
I had a good laugh	je me suis bien marré
I apologized	Je me suis excusé
I screwed up	je me suis gouré
I was interested in	je me suis intéressé
I got carried away	je me suis laissé emporter
I started to cry	je me suis mis à pleurer
I went to	je me suis rendu a
I did not take into account	je n&#x27;ai pas tenu compte
Can I close your tab?	je peux vous encaisser?
"i&#x27;ll take over	je prends le relai
"I&#x27;m quite tall	je suis assez grand
I am in contact with him	je suis au contact de lui
I am retired	je suis à la retrait
"I&#x27;m good at video games	je suis calé en jeux vidéo
"I&#x27;m happy to be here	"je suis content d&#x27;être ici/j&#x27;capote d&#x27;être icitte (canada)
"I&#x27;m standing	je suis debou
I am motivated	je suis déterre
"I&#x27;m motivated	je suis déterr
"I&#x27;m pissed	je suis en a asse
"I&#x27;m on my way	je suis en chemin/rout
I am inclined to talk with you	je suis enclin à parler avec toi
I am wasted	je suis foncedé
I am uneducated	je suis inculte
"I&#x27;m worried	Je suis inquie
I am clumsy	je suis maladroit
"I&#x27;m sorry	je suis navr
"I&#x27;m up for anything	je suis partant pour tou
I am retired	je suis retraité
I am tired	je suis rincé
i am drunk	je suis soûl
"I&#x27;m sauced	je suis torch
I am so down	je suis trop chaud
I got you involved in this	je t&#x27;ai mêlée á ça
fuck you	je t&#x27;emmerde
I can not hear you	je t&#x27;entends pas
I give you my word	je te donne ma parole
"i&#x27;m putting you in the deep end	je te mets au pied du mu
"it&#x27;s on me	je te paie la traite (canada
to take a look at	jeter un coup d&#x27;oeil
to take a look	jeter un oeil
board games	jeux de société
next question	joker
to juggle	jongler
to get someone angry	jouer avec les pieds de quelqu&#x27;un
to cum	jouir
public holiday	jour férié
youth	jouvence
Jewish	juif
twins	jumeaux
I said/did a weird thing	J’ai bugué
"I&#x27;m in love with you	J’ai craqué pour to
I’ve passed my exams very easily	J’ai réussi mes examens les doigts dans le nez
stop	khlass
the allocation	l&#x27;affectation
garlic	l&#x27;ail
the ease	l&#x27;aisance
the armpit	l&#x27;aisselle
the elder	l&#x27;aîné
the social progress	l&#x27;andamento
appetizer	l&#x27;apéritif = l&#x27;apéro
The appearance is deceptive	L&#x27;apparence est trompeuse
the bus stop	l&#x27;arrêt de bus
the rear	l&#x27;arrière
the rear	l&#x27;arrière
crafts	l&#x27;artisanat
the seasoning	l&#x27;assaisonnement
partner	l&#x27;associé
insurance	l&#x27;assurance
dawn	l&#x27;aube
warm water	l&#x27;eau tiède
the enclosure	l&#x27;enclos
hope	l&#x27;espoir
gasoline	l&#x27;essence
growth	l&#x27;essor
the growth	l&#x27;essor
the gap	l&#x27;écart
gap	l&#x27;écart
deadline	l&#x27;échéance
the touchscreen	l&#x27;écran tactile
the badge	l&#x27;écusson
praise	l&#x27;éloge
the sponge	l&#x27;éponge
the extent	l&#x27;étendue
the bishop	l&#x27;évêque
the intruder	l&#x27;intrus
goose	l&#x27;oie
The shadow	l&#x27;ombre
the speaker	l&#x27;orateur
pride	l&#x27;orgueil
swimming	la baignade
weed	la beu
bike	la bécane
beer	la binouze
mud	la boue
embers	la braise
toothbrush	la brosse à dents
mist	la brume
the shack	la cabane
hiding place	la cachette
drugs	la came
heat wave	la canicule
condom, car sunroof	la capote
the icing on the cake	la cerise sur le gâteau/la cerise sur le sundae (canada)
the hunt	la chasse
pussy	la chatte, foufoune, zezette/zizi
pumpkin	la citrouille
the bell	la cloche
the hill	la colline
gossip	la commère
bagpipes	la cornemuse
the crown	la couronne
the custom	la coutume
crime	la criminalité
growth	la croissance
cruelty	la cruauté
panties	la culotte/les gobettes (Canada)
the date is set	la date est fixée
rehab	la désintox
customs	la douane
duration / length	la durée/la longueur
lightning	la foudre
the crowd	la foule
slingshot	la fronde
the bowl	la gamelle
the trigger	la gâchette
the clerk	la greffière
the Mona Lisa	la Joconde
length and width	la longueur et la largeur
the trunk	la malle
the sleeve	la manche
the remote	la manette
the next step	la marche suivante
the bride	la mariée
Kindergarten	la maternelle
the people have spoken	la messe est dite
breadcrumbs	la mie de pain
the militia	la milice
the lead	la mine
change	la monnaie
the average	la moyenne
girlfriend	la nana, la copine, la gonzesse,  la loulotte
straw	la paille
paperwork	la paperasse/la paperasserie
fatherhood	la paternité
the homeland	la patrie
child support	la pension alimentaire
orgasm	la petite mort
pliers	la pince
Planning	la planification
most of the usual problems relate to	la plupart des problème usuels ayant trait à
the pan	la poêle
the powder	la poudre
doll	la poupée
the pursuit	la poursuite
The reason is	la raison en est
the rail	la rampe
pension	la rente
the start of the school year	la rentrée
the rescue	la rescousse
retirement	la retraite
ruler	la règle
success	la réussite
the left river bank	la rive gauche
the morning routine	la routine matinale
dirt	la saleté
the gym	la salle de gym
the bare minimum	la stricte nécessaire
the waist	la taille
the slice of bread	la tartine
storm	la tempête
the outfit	la tenue
the car	la tire
the piggy bank	la tirelire
alcohol/ to drink	la tise/tiser
trafficking/milking	la traite
the kit	la trousse
The valley	la vallée
lube	la vaseline
the sale	la vente
winemaking process	la vinification
wool	laine
secular	laïque
bacon	lardons
to bore	lasser
to weary	lasser
nom de famille	last name
forget about it	lâche l&#x27;affaire
to let go	lâcher
to let go/cut loose (have fun)	lâcher prise/lâcher son fou (canada)
the cattle	le bétail
the concrete	le béton
the thing, widget	le bidule
cap	le bonnet
the edge	le bord
the shield	le bouclier
the ball	le boule
the framework	le cadre
Tiling	Le carrelage
the field	le champ
construction site	le chantier
the big tent	le chapiteau
the sky is clear	le ciel est dégagé
treasure chest/safe/car trunk	le coffre
county	le comté
the competition	le concours
the lid	le couvercle
the cost	le coût
toothpaste	le dentifrice
ass	Le derrière, le postérieur, l’arrière-train, le fion, les fesses, le cul
jet lag	le décalage horaire
the deceased	le défunt
the feeling of being in a foreign land/to feel lost in a foreign land	le dépaysement/être dépaysé
lunch	le diner (canada)
the dormitory	le dortoir
the staff	le état-major
the farmer	le fermier
feast	le festin
le bordel (mess)	le foutoir
cum	le foutre
the shipping costs	le frais d&#x27;envois
money	le fric, le pognon, le blé, l&#x27;oseille, les sous, le flouze, la maille
the thrill	le frisson
funeral	le funérailles
lip gloss	le gloss
the attic	le grenier
the sink	le lavabo, la vasque
Laundry	le linge
the dispute	le litige
boyfriend	le loulou
the rent	le loyer
the shit/mess	le merdier
the social environment	le milieu social
the timer	le minuteur
the slightest doubt	le moindre doute
the bellybutton	le nombril
bandage	le pansement
the course	le parcours
godfather/godmother	le parrain/la marraine
end of term exam	le partiel
Heritage	le patrimoine
the bathroom	le petit coin
penis	Le pénis, la verge, la bite, la pine, le zob, le zizi, le quiqui, la queue
cheap wine	le pinard, le picrate, le pive
the lead	le plomb
the bed	le plumard/le pieu
fist	le poing
the pepper	le poivron
the principle	le principe
the process	le processus
the grid	le quadrillage
the shortcut	le raccourci
the story	le raconte
the relation	le rapport
Catch-up	Le rattrapage
receipt	le reçu
the shark	le requin
the tap is running	le robinet coule
the tap is leaking	le robinet fuit
a novel	le roman
sand	le sable
christmas tree	le sapin
the know-how	le savoir-faire
the path	le sentier
AIDS	le sida
The balance (payment)	le solde
the top	le sommet
dinner	le souper (canada)
apron	le tablier
the rate	le taux
the area that gives flavor to the product	le terroir
the nipple	le téton
the trip	le trajet
The belly	le ventre
a drink	le verre, le pot, le coup
dizziness	le vertige
dizzines	le vertige
old age	le vieillesse
the veil	le voile
criminal	le voyou, le truand, la caillera, la racaille, le malfrat
next day	lendemain
wings	les ailes
the matches	les allumettes
conflicts	les bagarres
chopsticks	les baguettes
the walks	les balades
the streamers	les banderoles
socks	les bas (canada)
property	les biens
the marbles	les billes
trinkets	les breloques
bubbles	les bulles
bumps	les cahots
canoes	les canots
the goose is cooked	les carottes sont cuites
slippers	les chaussons
the toilets	les chiottes
behind the scenes/backstage	les coulisses
groceries	les courses
customs	les coutumes
thighs	les cuisses
swans	les cygnes
school dropouts	les déscolarisés
piece of cake	les doigts dans le nez
sheets (bed)	les draps
issues	les enjeux
the surroundings	les environs
cash	les espèces
grocery stores	les épiceries
shooting Stars	les étoiles filantes
the cops	les flics, les keufs, les poulets, les schmitts, policier
funds	les fonds
the pebbles	les galets
the gums	les gencives
the bleachers	les gradins
the skyscrapers	les gratte-ciels
claws	les griffes
swear words	les gros mots
clothes	les habits
hips	les hanches
fees	les honoraires
mortgages	les hypothèque
the blades	les lames
the tears	les larmes
protests	Les manifestations/les manifs
the wonders	les merveilles
flies	les mouches
tits	les nichons
Boobs	Les nichons, les nibards, les miches, les nénés, les tétons
the nuts	les noix
short stories	les nouvelles
the orphans	les orphelins
toes	les orteils
grocery stores	les pakpak
headlights	les phares
coins	les pièces
the pots	les pots
bribes	les pots de vin
hens	les poules
relatives	les proches
the preys	les proies
over time	les prolongations
Leftovers	les restes
wrinkles	les rides
the circles	les ronds
alleys	les ruelles
the bastards	les salauds
cowboy boots	les santiags
hookups	les sexfriends
eyebrows	les sourcil
the blinds	les stores
trade unions	les syndicats
6 pack	les tablettes de chocolat
Tasks	les tâches
spider webs	les toiles d&#x27;araignée
widows	les veuves
the turns	les virages
Sunrise	lever du soleil
yeast	levure
light	léger
slight	léger
slightly	légèrement
legitimate	légitime
to pass down	léguer
to link	lier
ivy	lierre
related to	lié a
delivery	livraison
to deliver to	livrer à
to accommodate	loger
software	logiciel
distant	lointain
to eye	lorgner
to praise	louanger
to miss out	louper
lushious	luxuriant
my girlfriend	ma blonde (canada)
my life is ruined	ma vie est fichue
magic	magie
skinny	maigre
tomorrow	mainde
majestically	majestueusement
majority, minority	majoritaire, minoritaire
to go wrong	mal tourner
bad luck	malheur
smart	maligne
clever	malin
granny	mamie
fussy	maniaque
to orchestrate	manigancer
to bargain	marchander
cooking pot	marmite
to mumble	marmonner
leather goods	maroquinerie
to mask	masquer
to massage	masser
a draw	match nul
material	matière
morning	matin=mat(only with hours)
weeds	mauvaise herbes
to chew	mâcher
to threaten	menacer
thanks for listening to me	merci de m&#x27;avoir écouter
wonderful	merveilleux
my hobbies	mes loisirs
gentlemen	messieurs
ladies and gentlemen	messieurs-dames
lets end this	mettons fin à cela
to highlight	mettre en lumière
little known	méconnu
discontent	mécontent
media	médiatique
misdeeds	méfaits
to mix	mélanger
domestic work	ménager
to despise	mépriser
to despise	mépriser
job	métier
even in	même par
half time	mi-temps
microphone	micro
public urination	miction sur la voie publique
family	mifa (famille)
middle	milieu
environment	milieu
to advocate for	militer pour
thin/dammit	mince
to undermine	miner
minimal	minime
to count on (s.b/smth.), bet	miser sur
moderate	modéré
me neither	moi non plus
lesser	moindre
moldy	moisi
half	moitié
my boyfriend	mon chum (canada)
my ego took a hit	mon ego en a pris un coup
my setup	mon installation
my opponent	mon opposant
my cell phone	mon portable
my homie	mon poto
my relation to	mon rapport à
my nickname	mon surnom
my stomach	mon ventre
to get promoted	monter en grade
lips are sealed	motus et bouche cousue
soft	mou
meh	mouais
to get wet	Mouiller
wet	mouillé
fishing reel	moulinet de pêche
mustard	moutarde
average/way	moyen
average	moyenne
mute	muet
to multiply	multiplier
enclosure wall	mur d&#x27;enceinte
ripe	mûr
to mature	mûrir
tarantula	mygale
do not be afraid	n&#x27;ayez crainte
Nevertheless	N&#x27;empêche
any	n&#x27;importe quel/quelle
dwarf	nain
naive	naïf
etc.	nanani nanana
to no be an exception	ne pas échapper a la règle
"don&#x27;t worry	"ne t&#x27;en fais pas
clearly	nettement
Nevertheless (old word)	néanmoins
to require	nécessiter
harmful	néfaste
to neglect	négliger
silly	niais
to fuck	Niquer
hazelnut	noisette
number	nombre
numerous	nombreuse
to nominate	nommer
notorious	notoire
to tie	nouer
noodles	nouilles
to feed	nourrir
bad taste	nouveau riche
to harm	nuire
to harm	nuirer á
nowhere else	nulle part ailleurs
by no means	nullement
bow tie	nœud papillon
mandatory	obligatoire
to obsess	obséder
to cause	occasionner
mind your own business	occupe-toi de tes oignons
to bestow	octroyer
heinous	odieux
Oh nice one!	oh beau gosse!/ BG!
to omit	omettre
it looks like	on dirait que
"we&#x27;re up for it	on est partant
"we&#x27;re even	on est quitt
someone told me that	on m&#x27;a dit que
we turn up	on remonte
"we don&#x27;t care	"on s&#x27;en fiche
It feels like being	on se croirait
we enjoy cooking	on se fait plaisir à cuisiner
"we&#x27;re dipping	"on se tire d&#x27;ici/on sacre notre camp (canada)
we are going to visit some spots	on va visiter quelques points
creamy	onctueux
timely	opportun
gold	or
garbage	ordure
native	originaire
orphanage	orphelinat
"Yo, what&#x27;s going on	Ouesh, kafa
"Yes, but for the most part it&#x27;s still very revealing	"Oui , mais pour la plupart c&#x27;est quand même révélateur de beaucoup
besides	outre
outgoing	ouvert
handiwork	ouvrage
wherever you live	où que vous habitiez
to remove	ôter
regular bread	pain de mie
peaceful	paisible
palace	palais
thrilling	palpitant
Paris (Slang)	paname
trousers	pantalon
paper towel	papier sopalin
Furthermore	par ailleurs
On the other hand	par contre
by chance	par hasard
in terms of	par rapport à
in parallel to	parallèlement à
paranoid	parano
to browse/travel	parcourir
background	parcours
to ward	parer
to bet on	parier sur
to talk for nothing	parler pour ne rien dire
advocate	partisan
everywhere else	partout ailleurs
to reach	parvenir à
to achieve its goals	parvenir à ses fins
no wonder	pas étonnant
not just any toilet	pas n&#x27;importe quelles toilettes
Not so much	Pas tant que
horrible (slang)	pas terrible
to pass by really quickly	passer en coup de vent
to floss	passer la soie dentaire
to make a call	passer un coup de fil
to take an exam	passer un examun
exhilarating	passionnant
patrol boat	patrouilleur
poor	pauvre
dough	pâte
to suffer	pâtir
Parce que	Pck
to labour	peiner
to hang	pendre
to drill	percer
perched on	perché sur
to ram	percuter
to lose ones bearings	perdre ses repères
to persist	perdurer
personally	perso
to persuade	persuader
to disturb	perturber
pervert/kinky	pervers
firecracker/joint	petard, tarpé
no matter what	peu importe quoi
to populate	peupler
painful/burdensome	pénible
expired	périmé
journey	périple
to perish	périr
a joint	pétard
to fart	péter
"to loose one&#x27;s shit (crazy)	péter les plomb
to go crazy	péter les plombs
to mold	pétrir
to fish	pêcher
to photograph	photographier
to eat a bit	picorer
to trap	piéger
pedestrian	piéton
peppers	piments
to pinch	pincer
to sleep	pioncer/pieuter
to steal (slang)	piquer
to piss	pisser
to piss	pisser un coup
pity/mercy(in a pleading way)	pitié
pitiful	pitoyable
picturesque	pittoresque
the ceiling	le plafond
to plead	plaider
to please someone	plaire à quelqu&#x27;un
sequence shot	plan séquence
to glide	planer
to stash	planquer
to tackle	plaquer
to ditch something	plaquer quelque chose
tray	plateau
to fold/blend	plier
metal filling	plombage en métal
to dive	plonger
no harm done	plus de peur que de mal
more and more	plus en plus
the more formal the speech	plus un discours est formel
to stab	poignarder
hairy	poilu
end of story	point barre
peppers	poivrons
polishing	polissage
versatile	polyvalent
firefighter	pompier
deck	pont
to lodge a complaint	porter plainte
to yield results	porter ses fruits
to lay	poser
cowgirl	position d&#x27;Andromaque
to possess	posséder
to apply	postuler
vegetable garden	potager
"to divert someone&#x27;s attention	poudre de perlimpinpi
henhouse	poulailler
baby	poupée
for granted	pour acquis
for the time being	pour l&#x27;instant
for the millionth time	pour la millionième fois
in my opinion	pour ma part
so that I can	pour que je puisse
talks (noun)	pourparlers
to rot	pourrir
to pursue	poursuivre
to supply	pourvoir
to push	pousser
stroller	poussette
dusty	poussiéreux
First	premièrement
to take seriously	prendre au sérieux
to get shit faced	prendre une cuite
pull up a chair	prends une chaise/tire-toi une bûche (canada)
Take me from behind	Prends-moi par derrière
to prescribe	prescrire
prior	préalable
precarious	précaire
previous	précédent
to specify	préciser
early	précoce
preconceived	préconçue
to advocate	préconiser
to predict	prédire
to withdraw/remove	prélever
to claim/pretend	prétendre
alleged	prétendu
to prevail	prévaloir
prevent/warn	prévenir
predictable	prévisible
to pray	prier
principle	principe
to deprive of	priver de
private	privé
to privilege	privilégier
shortly	prochainement
to obtain	procurer
deep	profond
to walk the dog	promener le chien
promising	prometteur
to promote	promouvoir
to spread	propager
favorable to	propice à
property	propriété
to propel	propulser
to prove	prouver
to derive from	provenir de
provisionally/temporarily	provisoirement
to advocate	prôner
advertising	publicitaire
to publish	publier
childish	puéril
to draw (figuratively)	puiser
to punish	punir
"what&#x27;s the matter?	"qu&#x27;est-ce qu&#x27;il ya?
what are you doing? (vulgar)	qu&#x27;est-ce que tu fous
to lockdown	quadriller
when Pigs Fly	quand les poules auront des dents
when all of a sudden	quand tout à coup
as for	quant à
nearly	quasiment
its crap	que dalle
what flavor?	quel parfum
regardless of	quel que soit
what a relief	quel soulagement
what a numbskull	Quelle andouille
somewhere	quelque part
somewhat	quelque peu
regardless of	quelque soit
a few minutes	quelques minutes
stuck	québlo (bloqué)
anyone	quiconque
problem/misunderstanding	quiproquo
though	quoique
young style	racaille
junction	raccordement
to plug	raccorder
to hang up	raccrocher
to ramble	radoter
refreshing	rafraîchissant
steep/stiff	raide
to slow down	ralentir
to rally	rallier
to pick up	ramasser
electric train	rame électrique
to bring (a person)	ramener
to report/bring back	rapporter
to bring closer	rapprocher
to shave	raser
to gather	rassembler
reassuring	rassurant
to reassure	rassurer
to catch up with	rattraper
to ravage	ravager
ravishing	ravageur
lovely	ravissante
to revive	raviver
to scratch/scuff/cross out	rayer
stunning	rayonnant
to grumble	râler/ronchonner/grogner/bougonner
complainer	râleurs
to bounce	faire rebondir
to fail	recaler
recipe	recette
grateful	reconnaissant
to recruit	recruter
to rectify	rectifier
to collect	recueillir
to retreat	reculer
royalty fee	redevance
to repeat the course	redoubler
dreadful	redoutable
to dread	redouter
to straighten out	redresser
to reflect	refléter
chorus	refrain
to reject	rejeter
truck stop	relais routier
to recount	relater
to release	relâcher
to raise	relever
to relegate	reléguer
to link to	relier à
pack up your stuff	remballer tes affaires
to rewind	rembobiner
to refund	rembourser
get back to work	remets-toi au taf
to replace	remplacer
to stir	remuer
to make better	rendre meilleur
to me a favor	rends-moi service
reports	rendus
to contain	renfermer
introverted	renfermé,introverti
to replenish the funds	renflouer les caisses
to reinforce	renforcer
to reinforce	renforcer
to disown	renier
to sniff	renifler
to give up	renoncer à
to renew	renouveler
to renew	renouveler/reconduire
information	renseignement
to inform	renseigner
profitable	rentable
to overthrow, knock over, spill	renverser
to start from scratch	repartir à zero
to spot	repérer
to fold up	replier
relaxing	reposant
to rest	reposer
to repel/postpone	repousser
to resume	reprendre
to blame	reprocher
sharks	requins
to resolve	resoudre
to tighten	resserrer
remaining	restant
to restore	restaurer
return/refund/restore	restituer
to restrict	restreindre
to delay	retarder
to remove the message	retirer le message
withdrawn	retirées
feedback	retour
back to the roots	retour aux sources
back to square one	retour à la case départ
to meet up with friends	retrouver des amis
expensive	reuch (cher)
claim/demand	revendiquer
to take on	revêtir
settlement	règlement
to recap	récapituler
reciprocal	réciproque
to claim	réclamer
to harvest	récolter
to reward	récompenser
to scrub	récurer
to write up	rédiger
to refer	référer
to govern	régir
to regulate	réglementer
to pay	régler
to reign	régner
regular	régulier
to reiterate	réitérer
to allocate	répartir
to counter (verbally)	répliquer
to surpress	réprimer
to reside	résider
to solve	résoudre
to summarize	résumer
to restore	rétablir
alarm clock	réveil
to revise/review	réviser
to daydream	rêvasser
funny	rigolo
old fashion	ringard
to break up with	rompre avec
to nibble	ronger
commoner	roturière
rusty	rouillé
drum roll	roulement de tambour
to roll/drive	rouler
to french kiss	rouler un patin/rouler une pelle/galocher
road	routière
to ruin	ruiner
to refrain from	s&#x27;abstenir de
to mate	s&#x27;accoupler
to hang on	s&#x27;accrocher
to go at fiercely	s&#x27;acharner a
to complete	s&#x27;achever
to devote oneself to	s&#x27;adonner à
to get worked up	s&#x27;affoler
to team up with	s&#x27;allier à
realize	s&#x27;apercevoir
to get ready to	s&#x27;apprêter à
to approach	s&#x27;approcher
to linger	s&#x27;attarder
to expect	s&#x27;attendre à
empower yourself with thought	s&#x27;autonomiser par la pensée
to turn out to be	s&#x27;avérer
to warm up	s&#x27;echauffer
to collapse	s&#x27;effondrer
to strive to	s&#x27;efforcer de
to get away from	s&#x27;eloigner de
to get carried away	s&#x27;emballer
to get into physical contact	s&#x27;embrouiller
to seize	s&#x27;emparer
to prevent	s&#x27;empêcher
to eat like shit	s&#x27;empiffrer
to scurry	s&#x27;empresser
to go away	s&#x27;en aller
to not care	s&#x27;en branler
to take care of	s&#x27;en occuper
to fall asleep	s&#x27;endormir
to run away	s&#x27;enfuir
to get drunk	s&#x27;enivrer
to have fun/I had fun	s&#x27;enjailler/je me suis enjaillé
to pride oneself	s&#x27;enorgueillir
to jam	s&#x27;enrayer
to ensue	s&#x27;ensuivre
to help each other	s&#x27;entraider
to converse	s&#x27;entretenir
to fly away	s&#x27;envoler
to dry up	s&#x27;essuyer
to stretch	s&#x27;etirer
to have a blast	s&#x27;éclater
to flow	s&#x27;écouler
to exclaim/cry out	s&#x27;écrier
to collapse	s&#x27;écrouler
to go astray	s&#x27;égarer
to blossom	s&#x27;épanouir
to immerse yourself	s&#x27;imprégner de
to set in	s&#x27;incruster
to take care of	s&#x27;occuper de
biscuits	sablés
to sabotage	saboter
to sacrifice	sacrifier
to bleed	saigner
to seize	saisir
to input data	saisir des données
striking	saisissant
seasonal	saisonnier
do we ever know	sait-on jamais
wage	salarial
salty	salé
savory	salé
to greet	saluer
bloody	sanglant
without further ado	sans plus tarder
to annoy	saouler/souler
to fuck	Sauter
to catch the eye	sauter aux yeux
to back it up	sauvegarder
to savour	savourer
to seal	sceller
knowingly	sciemment
motorcycle	scooter
to swim	se baigner
to walk around	se balader
to get drunk	se bourrer la gueule
to jerk off	se branler
to leave	se casser, se tirer, se barrer
to argue	se chamailler
to bump your head	se cogner la tête
to drink alot	se coller/mettre une mine
to materialize	se concrétiser
to comply with	se conformer à
to wonder	se demander
to get rid of	se débarrasser de
to uncork	se déboucher
to chicken out	se dégonfler
dress up	se déguiser
to manage	se démerder
to become popular	se démocratiser
to surpass oneself	se dépasser
to shy away from	se dérober à
to take place	se dérouler
to dissociate	se désolidariser
to relax/chill	se détendre
to head towards	se diriger vers
to get entangled	se empetrer
to be bored	se faire chier
to make friends	se faire des amis
to throw around the ball	se faire des passes au ballon
to impersonate	se faire passer pour
to set yourself	se fixer
to trample	se fouler
"to stuff one&#x27;s face	se goinfre
to show off	se la péter
to get into	se lancer
to laugh	se marrer
to get drunk AF	se mettre un gros tarif
to be wary	se méfier
to be wary of	se méfier de
to be mistaken	se méprendre
to mingle with	se mêler aux
to mettle with	se mêler de
to make fun of	se moquer de
to drown	se noyer
to be passionate	se passionner
to lean forward	se pencher en avant
Allow yourself to	se permettre de
to leave	se péter
to prick yourself	se piquer
to complain	se plaindre
to be attracted	se plaire
to land	se poser
to rush	se précipiter
to walk around	se promener
to redeem oneself	se racheter
to remember	se rappeler
to recollect yourself	se recueillir
to engage in private prayer	se recueillir
to go to, on	se rendre à/sur
to realize	se rendre compte de
to get information on	se renseigner sur
to find your way	se repérer
to compose onself	se ressaisir
to revitalise yourself	se ressourcer
to feast	se régaler
to spread	se répandre
to rinse	se rincer
to bankrupt onself	se ruiner
to dress oneself	se saper
to utilise	se servir de
to be located	se situer
to overwork oneself	se surmener
to eat	se sustenter
to stand	se tenir
to keep	se tenir
stand	se tenir
to balance	se tenir en équilibre
to lug around	se trimballer
to be mistaken	se tromper de
to brag	se vanter
to brag	se venter
to dress yourself	se vêtir
to dry	secher
to shake	secouer
jesus christ!	seigneur, bon sang
similar	semblable
to sow	semer
serene	serein
to tighten/shake/hug	serrer
lock	serrure
sessions	séances
to seduce	séduire
to crack down	sévir
if you feel like it	si ça te tente
provided that	si tant est que
to flabbergast	sidérer
sit (metaphorically)	siéger
to whistle	siffler
whiskey	sky
supposedly	soi-disant
to tend to	soigner
carefully	soigneusement
to request/to apply for/to ask for	solliciter
dark	sombre
to sink into the abyss	sombrer dans l&#x27;abîme
summary	sommaire
sleeping pill	somnifère
to probe	sonder
to bear in mind	songer
to think about	songer à
house	sonmai
to sound/ring	sonner
sound	sonore
concerned	soucieux
to weld	souder
to bribe	soudoyer
to blow	souffler
to blow	souffler
desirable	souhaitable
to relieve	soulager
to raise	soulever
shoes	souliers
to submit a request	soumettre une demande
to suspect	soupçonner
suspicious	soupçonneux
flexible	souple
smile	sourire
in the form of	sous forme de
underwear	sous-vêtements/caleçon/culotte/les slips
to subscribe	souscrire
to subtract	soustraire
to subtract	soustraire
underground	souterrain
splendid	splendide
spontaneous	spontané
parking	stationnement
undergo/suffer	subir
to experience failure	subir un échec
sudden	subit
to remain	subsister
pacifier	sucette
sweet	sucré
sweat	sueur
to suffice	suffire
to suggest	suggérer
following the	suite au
following	suite à
to beg	supplier
on the background	sur fond
on site	sur place
he is gifted	il est surdoué
to arise	surgir
to overplay (acting)	surjouer
to overcome	surmonter
nickname	surnom
to overhang	surplomber
to surprise	surprendre
to jump	sursauter
to monitor	surveiller
to occur	survenir
survivor	survivant
to stimulate	susciter
to suspend	suspendre
To get laid	S’envoyer en l’air
have you sobered up a bit?	t&#x27;as dessoulé un peu?
"you don&#x27;t look like you get it	"T&#x27;as pas l&#x27;air d&#x27;avoir pigé
got a phone number?	t&#x27;as pas un 06?
"you&#x27;re handsome but you don&#x27;t look well	"t&#x27;as une belle gueule mais t&#x27;as une sale tête
You have a memory of a goldfish	T&#x27;as une mémoire de poisson rouge
"you&#x27;re lookin fresh	"t&#x27;es archi frais/fraîche
"you&#x27;re fucking crazy	"t&#x27;es dingue/t&#x27;es malade
smoking	tabagisme
to beat up	tabasser
stool	tabouret
heap (junk)	tacot
pencil sharpener	taille-crayon
to trim/carve	tailler
to give a blowjob	Tailler une pipe, faire une turlutte
to hush up	taire
Shut up	tais toi
Shut up	tais-toi
high heels	talons hauts
while	tandis que
So much better	Tant mieux
as long as	tant que
sometimes	tantôt
to type/beat	taper
type/hit	taper
carpet	tapis
to tease	taquiner
to delay	tarder
overdue	tardif
to spread	tartiner
to pack it in	tasser
jail	taule
to strive	tâcher
to ruin your day	te gâcher la journée
bottle	teillbou
to tint	teinter
such and such	tel ou tel
such as	tel que
to stretch	tendre
to tender	tendre
to keep you posted/to be in the know	tenir au courant/etre au courant
tempting	tentant
amazing (slang)	terrible
to text	textoter
chair lift	télésiège
look!	téma! (mater)
reckless	téméraire
to testify	témoigner
darkness	ténèbres
stubborn	têtu
"l&#x27;étude de la matière	the study of matte
theoretical	théorique
tuna	thon
small	tipeu
to kick/to steal (slang)	tirer
flush the toilet	tirer la chasse
to weave	tisser
title holder	titulaire
you know what i mean	toi-même tu sais
to eye scornfully	toiser
to get hooked	tomber accroc
to settle (on something)	tomber d&#x27;accord
to break down	tomber en panne
your will	ton gré
your opinion	ton regard
to mow the lawn	tondre la pelouse
napkin, rag	torchon
to twist	tordre
twisted	tordu
doctor	toubib
beat around the bush	tourner autour du pot
to beat around the bush	tourner autour du pot
to roll	tournicoter
suddenly	tout à coup
first of all	tout d&#x27;abord
after all	tout de même
right now	tout de suite
aloud	tout haut
the relevance of	tout l&#x27;intérêt de
all kinds	toutes sortes
to betray	trahir
to milk	traire
to treat	traiter
to hang around/drag	traîner
to sever, settle	trancher
to forward	transmettre
to be paid under the table	travailler au noir/etre payé au black
to cross	traverser
to dip	tremper
braids	tresses
4-leaf clover	trèfle à 4 feuilles
hectic	trépidant
to cheat	tricher
to slave away	trimer
to toast	trinquer
to triumph	triompher
three blocks from here	trois pâtés dici
to deceive	tromper
to saw	tronçonner
scooter	trottinette
to disrupt	troubler
to sit in state	trôner
whats his name	trucmuche
you got guts	tu as du cran
you crossed the line	tu as franchi la limite
"you&#x27;d better	tu as intérêt 
"you&#x27;re wrong	tu as tor
"you&#x27;re killing it	tu dead ç
"you&#x27;re sick (twisted)	tu es malsai
are you non french origin?	tu es typé?
you are ugly	tu es un thon
you scared me	tu m&#x27;as fait flipper
you owe me	tu m&#x27;es redevable
are you making fun of me?	tu m&#x27;niaises tu? (canada)
you rat on me	tu me balances
can you show me around paris?	tu me fais visiter paris?
"You&#x27;re driving me crazy (f/m)	Tu me rends folle/fo
"you&#x27;re not a genius in bed	"Tu n&#x27;es pas un génie au pieu.
you get it?	tu piges?
"you&#x27;re doing great	"tu t&#x27;en sors bien
You got head over heels	Tu t&#x27;es emballé
You are digressing	Tu t&#x27;éloigne
you figure it out (really vulgar)	tu te démerdes
are you kidding me?	tu te fou de ma gueule?
tile	tuile
future	turfu(futur)
pipe	tuyau
typical	typique
You look cute	T’as l’air mims
a priest	un abbé
an approach	un abord
an outcome	un aboutissement
a shelter	un abri
a moron	un abruti
a strong accent	un accent à couper au couteau
an accessory	un accessoire
a growth	un accroissement
a purchase	un achat
a routing	un acheminement
a deputy/assistance	un adjoint
a weakening	un affaiblissement
a confrontation	un affrontement
an eagle	un aigle
a lightening	un allégement
an ally	un allié
a layout	un aménagement
one year earlier	un an auparavant
an angel	un ange
a contribution	un apport
a supply	un approvisionnement
an asylum	un asile
murder	un assassinat
an assault	un assaut
an asset	un atout
an asset	un atout
an attack	un attentat
an indigenous	un autochtone
downstream	un aval
a warning	un avertissement
a confession	un aveu
a thing, project, plan, idea, lease	un bail
a broom	un balai
ball	un ballon/boule
a strip club	un bar de danseuses
a blocade	un barrage
a dam	un barrage
a basin/bowl	un bassin
an attractive person	un beau gosse/ une belle gosse
a profit	un bénéfice
un beau gosse/une belle gosse	un BG/une BG
bias	un biais
a burner phone	un bigo
balance sheet	un bilan
a village/a dump	un bled
lie	un bobard
a hipster, middle-class lefty	un bobo (bourgeois bohème)
a leap	un bond
an edge	un bord
a butcher	un boucher
an upheaval	un bouleversement
a book	un bouquin
a brew	un brassage
a shine	un brillant
a lighter	un briquet
a newsletter	un bulletin
a dead body	un cadavre
a frame	un cadre
a truck	un camion
an RV	un camping-car
a fuel	un carburant
a notebook	un carnet
a crossroad	un carrefour
a cardboard box	un carton
a nightmare	un cauchemar
A hug	Un câlin
a certificate	un certificat
a ceasefire	un cessez-le-feu
a grief	un chagrin
a blowtorch	un chalumeau
a field	un champ
a t-shirt	un chandail (canada)
a construction site	un chantier
a coal	un charbon
a blank check	un chèque en blanc
a surgeon	un chirurgien
unemployment	un chômage
unemployed person	un chômeur
a ranking	un classement
a binder	un classeur/un cartable (canada)
a collar	un col
a necklace	un collier
a fuel	un combustible
a merchant	un commerçant
Commissioner	un commissaire
a police station	un commissariat
companion	un compagnon
a conspiracy plot	un complot
an accountant	un comptable
a count (noble title)	un comte
a county	un comté
a fellow citizen	un concitoyen
a competitor	un concurrent
a colleague	un confrère
a time off	un congé
a spouse	un conjoint
a statement	un constat
a taxpayer	un contribuable
a convoy	un convoi
a rooster	un coq
a shell	un coquillage
a cord	un cordon
a sunset	un coucher de soleil
an elbow	un coude
a corridor	un couloir
a hit	un coup
a punch	un coup de poing
an email	un courriel
a pencil	un crayon à papier/un crayon de plomb (canada)
a skull	un crâne
a trough	un creux
a criteria	un critère
a priest, priestess	un curé/prêtre,prêtresse
dad/mom (slang)	un daron/une daronne
an applicant	un demandeur
a destiny	un destin
grief	un deuil/chagrin
a debate	un débat
an opening (figuratively)	un débouché
a death	un décès
a piece of trash	un déchet
a decline	un déclin
a decree	un décret
a flaw	un défaut
a flaw	un défaut
a challenge	un défi
a delegate	un délégué
a crime	un délit
a start up	un démarrage
an expense	un dépens
a spite	un dépit
a progress	un déroulement
a running	un déroulement
despair	un désespoir
a desire	un désir
a holder	un détenteur
a devil	un diable
a disagreement	un différend
a dilemma	un dilemme
a leader	un dirigeant
an ATM	un distributeur automatique
a guy	un djo
a donation	un don
a customs officer	un douanier
a collapse	un effondrement
a location	un emplacement
a loan	un emprunt
an engine	un engin
an issue	un enjeu
investigator	un enquêteur
a teacher	un enseignant
a training	un entraînement
a trainer	un entraîneur
a warehouse	un entrepôt
a slave	un esclave
a hope	un espoir
an excess	un excès
excess	un excédent
an outcast	un exclu
a presentation	un exposé
an extract/excerpt	un extrait
a gap	un écart
a sample	un échantillon
a splinter	un éclat
a writer	un écrivain
a pin	un épingle
a husband	un époux
a crew	un équipage
a range	un éventail
a bishop	un évêque
a beam	un faisceau
an armchair	un fauteuil
an iron	un fer
a farmer	un fermier
a feast	un festin
a marker	un feutre
A file	un fichier
a river	un fleuve
a plague	un fléau
a gun	un flingue
a flow	un flot
a blur	un flou
flow	un flux
liver	un foie
state employee	un fonctionnaire
a background	un fond
a little (drink-wise)	un fond
a foundation	un fondement
a ditch	un fossé
a ditch	un fossé
a whip/batter	un fouet
a van	un fourgon
a home	un foyer
a brake	un frein
a rifle	un fusil
a guy	un gadjo
a fee	un gage
a gas	un gaz
a knee	un genou
a giant	un géant
a gulf	un golfe
a warrior	un guerrier
a regular customer	un habitué
A coincidence	un hasard
a haven of peace	un havre de paix
an heir	un héritier
a rattle	un hochet
a host	un hôte
a building	un immeuble
a must-see	un incontournable
a clue	un indice
an individual	un individu
an infinity	un infini
a nurse	un infirmier
a schoolteacher	un instituteur
an interval	un intervalle
a speaker	un intervenant
isolation	un isolement
a nice jackpot	un joli pactole
a toy	un jouet
a day off	un jour de congé
a day off	un jour de congé
a twin	un jumeau
a laboratory	un laboratoire
a lake	un lac
a lamp post	un lampadaire
a reader	un lecteur
a dismissal	un licenciement
a place which is dear to my heart	un lieu qui me tient à coeur
housing	un logement
a software	un logiciel
a batch	un lot
a wolf	un loup
a rent	un loyer
lube	Un lubrifiant
"a thing, what&#x27;s his name	un machi
a swimsuit/soccer jersey	un maillot de bain/un maillot de foot
discomfort	un malaise
a misunderstanding	un malentendu
a misfortune	un malheur
a sleeve	un manche
a coat	un manteau
a merchant	un marchand
a deal	un marché
a sailor	un marin
a soccer match	un match de foot
a material	un matériau
a soft guy (not sensitive, but kind of slow)	un mec un peu mou
a lie	un mensonge
a murder	un meurtre
a murderer	un meurtrier
a discontent	un mécontentement
a medicine	un médicament
a household	un ménage
a disdain	un mépris
a job	un métier
a midnight	un minuit
a monk	un moine
a monster	un monstre
an amount	un montant
a snitch	un mouchard
a DM	un MP
a liar	un mytho
a ship	un navire
nothingness	un néant
a core	un noyau
a knot	un nœud
a thunderstorm	un orage
bone	un os
a hostage	un otage
a crazy person	un ouf
a bear	un ours
a tool	un outil
an underdog	un outsider
a handiwork	un ouvrage
worker	un ouvrier
a palace	un palais
a level (geography wise)	un palier
a woven basket	un panier
a sign/panel	un panneau
a pope	un pape
a package	un paquet
a paradise	un paradis
a course	un parcours
windshield	un pare-brise
a perfume	un parfum
a bet	un pari
hardwood floor	un parquet
partnership	un partenariat
heritage	un patrimoine
a landscape	un paysage
a peasant	un paysan
a sin	un péché
a lighthouse	un phare
a pitcher	un pichet
a trap	un piège
a trap	un piège
a pillar	un pilier
a pawn	un pion
a lie	un pipeau
investment	un placement
a floor	un plancher
a tray	un plateau/un cabaret (canada)
a tire	un pneu
a hair (body)	un poil
a fist	un poing
a firefighter	un pompier
a culvert	un ponceau
laptop/cellphone	un portable
a gate	un portail
a spokesperson	un porte-parole
a pot/jar	un pot
a lung	un poumon
a tip	un pourboire
a prejudice	un préjugé
a sample	un prélèvement
a loan	un prêt
a priest	un prêtre
a trial	un procès
a method/process	un procédé
a prosecutor	un procureur
an owner	un propriétaire
A landowner	Un propriétaire foncier
a well	un puits
a dock	un quai
a discount	un rabais/remise
a slow motion	un ralenti
a slowdown	un ralentissement
an encore (english usg.)	un rappel
an effect	un rapport
a gathering	un rassemblement
a radiation	un rayonnement
appeal	un recours
a collection	un recueil
a decline	un recul
a receipt	un reçu
a recovery	un redressement
a reflection	un reflet
a refusal	un refus
a statement	un relevé
a cure	un remède
a date (slang)	un rencard
a yield	un rendement
a reinforcement	un renfort
renewal	un renouveau
a renewal	un renouvellement
information	un renseignement
a dismissal	un renvoi
a landmark/benchmark	un repère
a withdrawal/regressiom	un repli
a deferral	un report
A rest	un repos
one representative	un représentant
a withdrawal	un retrait
a setback	un revers
a reign	un règne
a director	un réalisateur
a receiver	un récepteur
a narrative	un récit
a director	un régisseur
a network	un réseau
an alarm clock	un réveil
a cold	un rhume
a rock	un rocher
a rock	un rocher
A novelist	un romancier
a road/trucker	un routier
A Kingdom	un royaume
sand	un sable
salary	un salaire
an employee	un salarié
a bastard	un salaud
a jump	un saut
a rescue	un sauvetage
a scholar	un savant
a diagram	un schéma
a ballot	un scrutin
A lord	un seigneur
an oath	un serment
a threshold/doorstep	un seuil
a seat	un siège/place
a wake	un sillage
disaster	un sinistre
a base	un socle
a sleep	un sommeil
a summit	un sommet
a survey	un sondage
a cent	un sou
a breath	un souffle
a wish	un souhait
a relief	un soulagement
a hint/suspicion	un soupçon
a basement	un sous-sol
a status	un statut
a narcotic	un stupéfiant
a vote	un suffrage
a premium	un supplément
an additional cost	un surcoût
an increased workload	un surcroît de travail
a reprieve	un sursis
a suspense	un suspens
tobacco	un tabac
a tailor	un tailleur
carpet	un tapis
a bunch of	un tas de
a testimony	un témoignage
a witness	un témoin
french fillers	un tic de langage
a stamp	un timbre
a draw	un tirage
a roof	un toit
a wrongdoing	un tort
a turning point	un tournant
a tournament	un tournoi
a drawn line	un trait tracé
a treasure	un trésor
a triumph	un triomphe
a disorder	un trouble
a herd	un troupeau
a love killer (kills the mood)	un tue l&#x27;amour
a user	un usager
a vessel	un vaisseau
a belly	un ventre
a slope	un versant
a deposit	un versement
a widow	un veuf
dildo	Un vibromasseur, un godemichet, un gode
an old man	un vieillard
a rape	un viol
a Bank transfer	un virement bancaire
a screw	un vis
a neighborhood	un voisinage
A steering wheel	un volant
a section	un volet
a wish	un vœu
a shareholder	un/une actionnaire
an ancestor	un/une ancêtre
an accomplice	un/une complice
a policeman	un/une gendarme
a manager	un/une gestionnaire
a philosopher	un/une philosophe
a winner	un/une vainqueur
a difficult thing to do	una prise de tête
a subscription	une adhésion
a wing	une aile
an area	une aire
a match	une allumette
a look	une allure
an embassy	une ambassade
a fine	une amende
a friendship	une amitié
an extent, magnitude	une ampleur
anxiety	une angoisse
an antenna	une antenne
ownership	une appartenance
an app	une appli
an approval	une approbation
"a scam/it&#x27;s a rip off	"une arnaque/c&#x27;est de l&#x27;arnaque
an arrest	une arrestation
a plate	une assiette
a seat/basis	une assise
infringement	une atteinte
a dawn	une aube
a highway	une autoroute
a fight	une bagarre
a bay/berry	une baie
a barrier/fence/gate	une barrière
a wound	une blessure
a box/company	une boite
a terminal	une borne
a breath	une bouffée
a ball	une boule
a scholarship	une bourse d&#x27;étude
a breach	une brèche
a bubble	une bulle
testicles	Une burne, une coucougnette, les bijoux de famille
a cabin	une cabine
a ski mask	une cagoule
cash register/car/box	une caisse
a jug	une carafe
complimentary water	une carafe d&#x27;eau
RV	une caravane/une roulotte (canada)
a hut	une case
a whore	une catin
a belt	une ceinture
a flesh	une chair
a heat	une chaleur
a hunt	une chasse
a chronicle	une chronique
a waterfall	une chute d&#x27;eau
a target	une cible
a citizenship	une citoyenneté
a slap	une claque
clarity	une clarté
a key	une clef
a customer	une clientèle
a bell	une cloche
a fence/closure	une clôture
an anger	une colère
a hill	une colline
a column	une colonne
a component	une composante
a consultation	une concertation
a competition	une concurrence
a conquest	une conquête
a deposit	une consigne
a constraint	une contrainte
a rope	une corde
a rating	une cote
a membership fee	une cotisation
a diaper/layer	une couche
a diaper	une couche
a cut	une coupure
a court	une cour
a curve	une courbe
a crown	une couronne
a custom	une coutume
a fear	une crainte
a crest/mohawk	une crête
a cruise	une croisière
a growth	une croissance
a belief	une croyance
a guilt	une culpabilité
a bowl	une cuvette
a residence	une demeure
downhill	une descente
a debt	une dette
motto/currency	une devise
a decade	une décennie
a discovery	une découverte
a failure	une défaillance
a defeat	une défaite
an approach	une démarche
a resignation	une démission
an expense	une dépense
a drift	une dérive
relaxation	une détente
distress	une détresse
a disappearance	une disparition
efficiency	une efficacité
a hiring	une embauche
a fingerprint	une empreinte
investigation	une enquête
an agreement	une entente
an interview	une entrevue
a scope (figuratively)	une envergure
hope	une espérance
an era	une ère
ladder/scale	une échelle
a deadline	une échéance
riot	une émeute
savings	une épargne
a thorn	une épine
a test	une épreuve
a range	une étendue
an extent	une étendue
a weakness	une faiblesse
a flaw/loophole	une faille
bankruptcy	une faillite
a foul	une faute
A blowjob	Une fellation, une pipe
a farm	une ferme
firmness	une fermeté
a lucky charm	une fève
a form	une fiche
pride	une fierté
a queue	une file
a little girl	une fillette
A flame	une flamme
a favor	une fleur
an arrow	une flèche
a fleet	une flotte
a faith	une foi
a fair	une foire
once again	une fois de plus
a pit	une fosse
a crowd	une foule
a supply	une fourniture
a hit	une frappe
fraud	une fraude
a leak	une fuite
a smoke	une fumée
a range	une gamme
a waffle	une gaufre
policeforce	une gendarmerie
a management	une gestion
a glory	une gloire
a shoe	une godasse
A girl	Une gonz/une go/une gadji/une nana
a drop	une goutte
a size	une grandeur
a grid	une grille
pregnancy	une grossesse
a hatred	une haine
an increase	une hausse
height	une hauteur
a grass/herb	une herbe
a hierarchy	une hiérarchie
a clock	une horloge
A mood	une humeur
a dead end	une impasse
taxation	une imposition
an incentive	une incitation
a worry	une inquiétude
an inadequacy	une insuffisance
a ban	une interdiction
a pop quiz	une interrogation/une interro
an intimacy	une intimité
an outcome/exit	une issue
a youth	une jeunesse
an accuracy	une justesse
a gap	une lacune
a reading	une lecture
a bookstore	une librairie
a unicorn	une licorne
a delivery	une livraison
a town hall	une mairie
"master&#x27;s degree	une maîtris
a sickness	une maladie
merchandise	une marchandise
a tide	une marée
a margin	une marge
a school subject	une matière scolaire
a morning	une matinée
a wimp	une mauviette
a threat	une menace
a wonder	une merveille
distrust	une méfiance
an update	une mise à jour
a notice	une mise en demeure
a misery	une misère
a globalization	une mondialisation
a rise	une montée
an average of	une moyenne de
a mutation/transfer	une mutation
a chick	une nana
a shuttle	une navette
a novelty	une nouveauté
one sleepless night	une nuit blanche
a work of art	une oeuvre d&#x27;art
a shadow	une ombre
a wave	une onde
a prescription	une ordonnance
an opening	une ouverture
failure	une panne
car breakdown	une panne de voiture
a homeland	une patrie
poverty	une pauvreté
a painting	une peinture
a housewarming	une pendre la crémaillère
a slope	une pente
a loss	une perte
a shortage	une pénurie
a stone	une pierre
a battery	une pile
a pinch of chili pepper	une pincée de poudre de piment
a track	une piste
a complaint	une plainte
a plate	une plaque
a sewer plate	une plaque d&#x27;égouts
a feather	une plume
a frying pan	une poêle
a handful	une poignée
A handshake	Une poignée de main
a breast	une poitrine
a pump	une pompe
a scope	une portée
a powder	une poudre
a hen	une poule
a pursuit	une poursuite
a push	une poussée
a dust	une poussière
a benefit	une prestation
a claim	une prétention
a prayer	une prière
a bonus	une prime
A plug outlet	une prise de courant
prey	une proie
a spread	une propagation
a flee	une puce
a power	une puissance
a punishment	une punition
a quarrel	une querelle
a tail	une queue
a quest	une quête
a root	une racine
a hike	une randonnée/une rando
a relaunch	une relance
a renewal	une reprise
a request	une requête
a deduction	une retenue
a fallout	une retombée
a revenge	une revanche
a demand	une revendication
a claim	une revendication
review	une revue
a harvest	une récolte
an award	une récompense
an award/reward	une récompense
a payment	une rémunération
a repair	une réparation
a distribution	une répartition
a replica/reply	une réplique
reluctance	une réticence
A wealth	une richesse
a shore	une rive
a river	une rivière
a wheel	une roue
a ruin	une ruine
a greenhouse	une serre
a session	une séance
a drought	une sécheresse
a thirst	une soif
a fee	une somme
flexibility	une souplesse
a mouse	une souris
a survival	une survie
a security	une sûreté
synthesis	une synthèse
a stain	une tache
a task	une tâche
a tenderness	une tendresse
a water content	une teneur en eau
an attempt	une tentation
a tent	une tente
an outfit	une tenue
a reality show	une télé-réalité
a canvas	une toile
a chef hat	une toque
a key	une touche
a tour	une tournée
a betrayal	une trahison
a framework	une trame
a slice	une tranche
a crossing	une traversée
a truce	une trêve
delicious	une tuerie
factory	une usine
a star(clout)	une vedette
a virtue	une vertu
a virgin	une vierge
around twenty	une vingtaine
an aim	une visée
a glass pane	une vitre
a display case	une vitrine
a path	une voie
a route	une voie
a view	une vue
to wear out	user
go fuck yourself	va chier
go away	va t&#x27;en
to defeat	vaincre
valid	valable
to be worth it	valoir le coup
to go about your business	vaquer à vos occupations
to ensure that	veiller à ce que
to revenge, vindicate	venger
verdant	verdoyant
stretch Marks	vergetures
towards	vers
around noon	vers midi
to pour	verser
medicinal properties	vertus médicinales
dressing room	vestiaire
widow	veuve
to convoy	véhiculer
genuine	véritable
workable	viable
empty	vide
to empty	vider
bright	vif
vigorous	vigoureux
to transfer funds	virer
to fire	virer, licencier
manly	viril
to aim at	viser à
to inspect a place	visiter
strongly	vivement
to veil	voiler
even	voire
vicinity	voisinage
willingly	volontiers
to vow	vouer
"You&#x27;re pissing me off	"vous m&#x27;emmerdez
"you weren&#x27;t up to the task	"vous n&#x27;avez pas été à la hauteur
thug	voyou
in all likelihood	vraisemblablement
since/because	vu que
as I am american	vu que je suis americain
there is nothing	y a R
including me	y compris moi
for real, as if, like	za3ma
forget her	zappe-la
go	ziva (vas-y)
to work	œuvrer
to be around 50 years old	avoir la cinquantaine
with regards to children..	en ce qui concerne les enfants..
lazy	paresseux
one night stand	un coup d&#x27;un soir
the washing	la lessive
accommodation certificate	attestation d&#x27;hébergement
to fill out	remplir
a sled	un traîneau
uncle	tonton
to rejuvenate	rajeunir
to skyrocket in price	flamber
obviously	évidemment
to compensate (a lack of something)	pallier
settlers	les colons
"it&#x27;s raining (quebec)	il mouill
to talk (quebec)	jaser
to have a conversation (quebec)	piquer une jasette
outdated	demodé
tow truck (France)/convenience store (Canada)	un dépanneur
the grocery store	l&#x27;épicerie
hardware store	quincaillerie
"we&#x27;re out of stock	on est en ruptur
to register in a course	s&#x27;incrire à un cours
no matter where I am..	peu importe où je suis..
that being said..	ceci étant dit..
as far back as I can remember	d&#x27;aussi loin que je me souvienne
la fête (verlan)	la teuf
building	l&#x27;immeuble
tissue	le mouchoir
foosball	le babyfoot
I have no doubts	je n&#x27;en doute point
to resume viewing	reprendre le visionnage
the bread section	le rayon pain
to win the elections	remporter les elections
model	le mannequin
to practice	faire ses gammes
to baffle	dérouter
"to be on one&#x27;s guard	veiller au grai
in the evening	à la veillée
the bare minimum	le stricte nécessaire
cheers!	cul sec
to register/enroll	s&#x27;inscrire
enough is enough	trop c&#x27;est trop
a tongue twister	un virelangue
to stand in line	faire la queue
a bouncer	un videur
to be sore	avoir des courbatures
"I&#x27;ve been scammed	je me suis fait arnaque
to have a snack	casser la croûte
a shopkeeper	un commerçant
henceforth	désormais
to snack	grignoter
the docks	les quais
"to lose one&#x27;s mind	perdre la boul
stay with me! (don't give up)	lâche pas
trickery	le baratin
a blowgun	une&nbsp;sarbacane
a cartridge	une&nbsp;cartouche
a quiz	un&nbsp;contrôle
to repeat a class	<b>r</b>edoubler une classe
pillow	l'oreiller
brother (verlan)	le reuf
<div>rare / medium rare / medium / medium well / well done</div>	<div>saignant&nbsp;/ à&nbsp;point&nbsp;/ entre à point et bien cuit&nbsp;/ bien cuit / très bien cuit</div>
